&&&&&A&&&&&&&
&   &       &
& & & & &&&&&
& & & &     &
& &   &&&&& &
& &&&&& &   &
& &     & & &
& & &&&&& & &
& &     & & &
& &&& &&& & &
&     &   & &
&&&&&&&B&&&&&