&&&&&&&&&&&&&&&&&&&&
A          &   &&& &
&&&&& &&&& & &     &
&     &      & &&& &
&&&&&&&&&&&&&& &&B &
&              &   &
&&&&&&&&&&&&&&&&&&&&