&&&&&&&&&&&&&&&&&&&&&&&&&&&&&&&&&&&&&&&
A       &                             &
                                      &
                                      &
                                     &&
               &                      &
                          &           &
                                 &    &
                  &                   &
                  &                   &
    &             &                 B &
&&&&&&&&&&&&&&&&&&&&&&&&&&&&&&&&&&&&&&&