&&&&& &&
& &&  B&
& && &&&
&    & &
& &&&& &
& &&&& &
&A     &
&&&&&&&&